###############################
#.............................#
#.............................#
#.............................#
#.............................#
#.............................#
#.............................#
#.............................#
#.............................#
#.............................#
#.............................#
#.............................#
#.............................#
#..............<..............#
#.............................#
#.............................#
###############################